............
............
..x......x..
.xxx....xxx.
xxxxx..xxxxx
xxxxx..xxxxx
.xxx....xxx.
..x......x..